NO ./textures/north.xpm
SO ./textures/south.xpm
WE ./textures/west.xpm
EA ./textures/east.xpm

F 220,100,0
c 100,200,50
C 225,30,0

111111
100001
1100N1
111111
